**S*************************************
*          *                           *
*     *    *                           *
*     *    *                           *
*******    *                           *
*          *   *             ***********
*          *   *                       *
*     ******   *                       *
*              *                       *
*              *                ********
*              *                       *
*              *                       *
*              *                       *
*********      *                       *
*              *                       *
*              *                       *
*              *                       *
*              *                       *
*              *                       *
*************************************F**